########
#      #
# P B T#
#      #
########
