##########
#        #
# P  B   #
#   B    #
#  T     #
#     TX #
##########
